0000000000000
A1X1010101Y10
010101Z101010
0101011101010
1101000001010
1000010100000
1011000001101
0000010100000
0101011101010
0101011101010
0101011101B10
000001C100000
