A_________X____
_______________
_______________
_______________
_______________
_______________
##___________##
C#############Z
##___________##
_______________
B_________Y____
_______________
_______________
_______________
_______________