A______#__X____
_______#_______
_______#_______
_______#_______
_______#_______
_______#_______
##_____#_____##
C#_____#_____#Z
##_____#_____##
_______#_______
B______#__Y____
_______#_______
_______#_______
_______#_______
_______#_______