A_________X____
_______________
_______________
_______________
_______________
_______________
B_________Y____
_______________
_______________
_______________
_______________
##___________##
C#___________#Z
##___________##
_______________